XXXXXXXXXXXXXXXXXXXX
X......X.X...X.....X
X...X..X....X....X.X
X.Z....X..S...X....X
X...X.......ZX..Z.PX
X..Z...Z.X..P......X
X...X......X..X.X..X
X...X..X.X......X..X
X....P....X.X....X.X
X..X.......X.......X
X......Z..XX..X....X
X....X..Z...X..XX..X
X.X.X.....X........X
X..X...Z..XX.......X
XXXXXXXXXXXXXXXXXXXX
