XXXXXXXXXXXXXXXXXXXX
X.....X.P..XX......X
X.X...P..XP...X.X..X
X............X.....X
X...X....X.X....X..X
X..XZ....X.....ZX..X
X.....XXX..........X
X..X...............X
X..X.XXX........Z..X
X...X......Z.......X
X.X......XXP...XP.XX
X..X...X...Z...P..XX
X..X.X.XP......P.X.X
X..X.....S.X.XX....X
XXXXXXXXXXXXXXXXXXXX
