XXXXXXXXXXXXXXXXXXXX
X....PX...XX.......X
X..............X...X
X.X......ZZ.......XX
X.XXX.........X..X.X
X......XP...X.X.P..X
X...X.............PX
X....XZ.P..X.......X
X........P.X.......X
XP.................X
XX........X....X...X
XX...X.....S...P...X
XX...........XX....X
X...X....XX.X..X...X
XXXXXXXXXXXXXXXXXXXX
