XXXXXXXXXXXXXXXXXXXX
X..X...........X..XX
X..X....PXP..P.....X
X.P..XX............X
X........P...S..X..X
X....X...X...XXX...X
X..X........XZ.PX..X
X..X.......X.Z.....X
X...X.X............X
XX..PX.......X..X.XX
XX...........X.X...X
XZ...Z...........X.X
X.X............X..XX
X.........X...P.Z.ZX
XXXXXXXXXXXXXXXXXXXX
