XXXXXXXXXXXXXXXXXXXX
X...............X.XX
X...X......Z..X....X
X......X...........X
X..X......X..X.....X
X................X.X
XX.X.X..X..P.Z.....X
X.X.S..............X
X....X........X.X..X
X.XX.........X.X.X.X
X.............XXPX.X
X......X..P........X
X...X.......XX.....X
XX.....X.....Z.....X
XXXXXXXXXXXXXXXXXXXX
