XXXXXXXXXXXXXXXXXXXX
X......X..........XX
X.Z....X.P..P.X....X
X.X..............X.X
XP.X.........XZX...X
X.....X....X...P...X
X....X......X.X.X..X
X.X..X....Z.....P..X
X....X..X......X...X
XX.X........X......X
XP........Z........X
X.....Z.......S....X
X...........XPX....X
XX..X.X......X....XX
XXXXXXXXXXXXXXXXXXXX
