XXXXXXXXXXXXXXXXXXXX
XZ......XX....PXX..X
XX..ZX...X.........X
X....P........P....X
XX.S.X.....XXZX....X
XXX......XX.....Z.XX
X.X...P.X....X.XX..X
X.XZ..........X....X
X.............P..X.X
X..XP..............X
X....P..X.......X..X
X........ZX....X..XX
X.XXXXX.......P....X
X.X..XX..X.........X
XXXXXXXXXXXXXXXXXXXX
