XXXXXXXXXX
X..E....SX
X.XX.X.X.X
X....X...X
XX.X.X.X.X
X..Z.....X
X.X.XXXX.X
XP.......X
XXXXXXXXXX
